TILEMAP
14 32 							-- Size of tile map in tiles
128 32 32						-- Tile size & block size
images/bloques.png 	-- Tilesheet
1 8 								-- Number of tiles in tilesheet
88888888888888
8            8
8            8
8            8
8            8
8            8
8            8
8            8
8            8
8            8
8            8
8            8
8            8
8            8
8   5        8
8            8
8            8
8     555    8
8            8
8            8
8   5        8
8            8
8            8
8     555    8
8            8
8            8
8            8
8            8
8     555    8
8            8
8            8
88888888888888

