TILEMAP
24 24							-- Size of tile map in tiles
14 32 							-- Tile size & block size
images/test2.png 	-- Tilesheet
5 1 								-- Number of tiles in tilesheet
111111111111111111111111
1                      1
1                      1
1                      1
1   234567    894477   1
1                      1
1                      1
1                      1
1            1 1 1 1 1 1
1                      1
1                      1
1                      1
1111   1111   33   44  1
1                      1
1                      1
1               111    1
1                      1
1111   111  22       221
1             22   22  1
1              22222   1
1                      1
1                      1
1                      1
111111111111111111111111

