TILEMAP
14 155						-- Size of tile map in tiles
128 32 32						-- Tile size & block size
images/bricks4.png 	-- Tilesheet
4 10                     -- Number of tiles in tilesheet
0103030303030303030303030302
0113272527252725272527251402
0115282628262826282628261602
0113040407070707070704041402
0115040407101010100704041602
0133333333171917193333333302
0115161516182018201516151602
0113040414130404141304041402
0115311504212321230416291602
0113321304222422240414301402
0115040416150404161504041602
0113191719171917191719171402
0115201820182018201820181602
0133331314041004101314333302
0115161516100410041516151602
0113141314060606061314131402
0115161516061615061516151602
0113141314061413061314131402
0115161516063333061516151602
0113141314131413141314131402
0115161516151615161516151602
0113141314131413141314131402
0115161516151615161516151602
0113141314131413141314131402
0115161516151615161516151602
0113141314131413141314131402
0115161516151615161516151602
0103030303000000000303030302
0000000000000000000000000000
0000000000000000000000000000
0000000000000000000000000000
0103030303030303030303030302
0113141314131413141314131402
0115050516050707051505051602
0113051307040404040714051402
0115160707041615040707151602
0113141305040404040514131402
0115051016151615161510051602
0113101005100404100510101402
0115101516151615161516101602
0113101314131413141314101402
0115161516151615161516151602
0113141314131413141314131402
0115161516151615161516151602
0113141314131413141314131402
0110101010151615161010101002
0113141314131413141314131402
0108161508151615160816150802
0108141308131413140814130802
0108333308151615160833330802
0113141314131413141314131402
0115161516151615161516151602
0113141314131413141314131402
0115161516151615161516151602
0113141314131413141314131402
0115161516151615161516151602
0104040414131413141304040402
0115041516151615161516041602
0103030303000000000303030302
0000000000000000000000000000
0000000000000000000000000000
0000000000000000000000000000
0103030303030303030303030302
0113140714130707141307131402
0115160716151615161507151602
0113070714131413141307071402
0115161516151615161516151602
0113141314131413141314131402
0115041516150808161516151602
0113041314080606081314131402
0115041508063333060816151602
0113040806060606060608131402
0115080606040606040606081602
0113140806043413040608041402
0115161508041615040816041602
0113141314081413081314041402
0115161516150808161516041602
0113141314131413141314131402
0115161516151615161516151602
0113141314131413141314131402
0115161516151615161516151602
0113141314131413141314131402
0115161516151615161516151602
0113141314131413141314131402
0115161516151615161516151602
0113141314131413141314131402
0115161516151615161516151602
0113141314131413141314131402
0115161516151615161516151602
0103030303000000000303030302
0000000000000000000000000000
0000000000000000000000000000
0000000000000000000000000000
0103030303030303030303030302
0113141314131413141314131402
0115161516151615161516151602
0113141314131413141314131402
0115331516151615161516331602
0113053314131413141333051402
0115051516151615161516051602
0113051314131413141314051402
0115051516050505051516051602
0113051333131413143314051402
0115053307151615160733051602
0113330704131413140407331402
0133070416151615161504073302
0113041314131413141314041402
0115161516151615161516151602
0113141314131413141314131402
0115161516151615161516151602
0113141314131413141314131402
0115161516151615161516151602
0113141314131413141314131402
0115161516151615161516151602
0113141314131413141314131402
0115161516151615161516151602
0113141314131413141314131402
0115161516151615161516151602
0113141314131413141314131402
0115161516151615161516151602
0103030300000000000003030302 
0000000000000000000000000000
0000000000000000000000000000
0000000000000000000000000000
0000000000000000000000000000
0000000000000000000000000000
0000000000000000000000000000
0000000000000000000000000000
0000000000000000000000000000
0000000000000000000000000000
0000000000000000000000000000
0000000000000000000000000000
0000000000000000000000000000
0000000000000000000000000000
0000000000000000000000000000
0000000000000000000000000000
0000000000000000000000000000
0000000000000000000000000000
0000000000000000000000000000
0000000000000000000000000000
0000000000000000000000000000
0000000000000000000000000000
0000000000000000000000000000
0000000000000000000000000000
0000000000000000000000000000
0000000000000000000000000000
0000000000000000000000000000
0000000000000000000000000000
0000000000000000000000000000
0000000000000000000000000000
0000000000000000000000000000
0000000000000000000000000000