TILEMAP
14 121						-- Size of tile map in tiles
128 32 32						-- Tile size & block size
images/bricks2.png 	-- Tilesheet
4 10                     -- Number of tiles in tilesheet
0103030303030303030303030302
0113141314131413141314131402
0115161516151615161516151602
0113141314131413141314131402
0115161516151615161516151602
0113141314131413141314131402
0115161516151615161516151602
0113141314131413141314131402
0115161516151615161516151602
0113141314131413141314131402
0115161516151615161516151602
0113141314131413141314131402
0115161516151615161516151602
0113141314131413141314131402
0115161516151615161516151602
0113141314131413141314131402
0115161516151615161516151602
0113141314131413141314131402
0115161516151615161516151602
0113141314131413141314131402
0115161516151615161516151602
0113141314131413141314131402
0115161516151615161516151602
0113141314131413141314131402
0115161516151615161516151602
0113141314131413141314131402
0115161516151615161516151602
0103030303000000000303030302
0000000000000000000000000000
0000000000000000000000000000
0000000000000000000000000000
0103030303030303030303030302
0113141314131413141314131402
0115161516151615161516151602
0113141314131413141314131402
0115161516151615161516151602
0113141314131413141314131402
0115161516151615161516151602
0113141314131413141314131402
0115161516151615161516151602
0113141314131413141314131402
0115161516151615161516151602
0113141314131413141314131402
0115161516151615161516151602
0113141314131413141314131402
0115161516151615161516151602
0113141314131413141314131402
0115161516151615161516151602
0113141314131413141314131402
0115161516151615161516151602
0113141314131413141314131402
0115161516151615161516151602
0113141314131413141314131402
0115161516151615161516151602
0113141314131413141314131402
0115161516151615161516151602
0113141314131413141314131402
0115161516151615161516151602
0103030303000000000303030302
0000000000000000000000000000
0000000000000000000000000000
0000000000000000000000000000
0103030303030303030303030302
0113141314131413141314131402
0115161516151615161516151602
0113141314131413141314131402
0115161516151615161516151602
0113141314131413141314131402
0115161516151615161516151602
0113141314131413141314131402
0115161516151615161516151602
0113140607060713141314131402
0115161516151615161516151602
0113141314131413141314131402
0115161516151615161516151602
0113141314131413141314131402
0115161516151615161516151602
0113141314131413141314131402
0115161516151615161516151602
0113141314131413141314131402
0115161516151615161516151602
0113141314131413141314131402
0115161516151615161516151602
0113141314131413141314131402
0115161516151615161516151602
0113141314131413141314131402
0115161516151615161516151602
0113141314131413141314131402
0115161516151615161516151602
0103030300000000000003030302
0000000000000000000000000000
0000000000000000000000000000
0000000000000000000000000000
0103030303030303030303030302
0113141314131413141314131402
0115161516151615161516151602
0113141314131413141314131402
0115161516151615161516151602
0108080810101413141314131402
0104041516151615161516151602
0113141314131413141314131402
0108080810101615161516151602
0113141314131413141314131402
0115161516151615161516151602
0113141314131413141314131402
0115161516151615161516151602
0113141314131413141314131402
0115161516151615161516151602
0108080810101413141314331402
0115161516151615171516341602
0113141314131413181314131402
0115161516151615161516151602
0113141314131413141314131402
0115161516151615161516151602
0113141314131413141314131402
0115161516151615161516151602
0108080810101413141314131402
0115161516151615161516151602
0113141314131413141314131402
0115161516151615161516151602
0103030303000000000303030302