TILEMAP
14 121						-- Size of tile map in tiles
128 32 32						-- Tile size & block size
images/bricks.png 	-- Tilesheet
4 4                     -- Number of tiles in tilesheet
0103030303030303030303030302
0113141314131413141314131402
0115161516151615161516151602
0113141314131413141314131402
0115161516151615161516151602
0113141314131413141314131402
0115161516151615161516151602
0113141314131413141314131402
0115161516151615161516151602
0113141314131413141314131402
0115161516151615161516151602
0113141314131413141314131402
0115161516151615161516151602
0113141314131413141314131402
0115161516151615161516151602
0113141314131413141314131402
0115161516151615161516151602
0113141314131413141314131402
0115161516151615161516151602
0113141314131413141314131402
0115161516151615161516151602
0113141314131413141314131402
0115161516151615161516151602
0113141314131413141314131402
0115161516151615161516151602
0113141314131413141314131402
0115161516151615161516151602
0103030303000000000303030302
0000000000000000000000000000
0000000000000000000000000000
0000000000000000000000000000
0103030303000000000303030302
0113141314131413141314131402
0115161516151615161516151602
0113141314131413141314131402
0115161516151615161516151602
0113141314131413141314131402
0115161516151615161516151602
0113141314131413141314131402
0115161516151615161516151602
0113141314131413141314131402
0115161516151615161516151602
0113141314131413141314131402
0115161516151615161516151602
0113141314131413141314131402
0115161516151615161516151602
0113141314131413141314131402
0115161516151615161516151602
0113141314131413141314131402
0115161516151615161516151602
0113141314131413141314131402
0115161516151615161516151602
0113141314131413141314131402
0115161516151615161516151602
0113141314131413141314131402
0115161516151615161516151602
0113141314131413141314131402
0115161516151615161516151602
0103030303000000000303030302
0000000000000000000000000000
0000000000000000000000000000
0000000000000000000000000000
0103030303000000000303030302
0113141314131413141314131402
0115161516151615161516151602
0113141314131413141314131402
0115161516151615161516151602
0113141314131413141314131402
0115161516151615161516151602
0113141314131413141314131402
0115161516151615161516151602
0113141314131413141314131402
0115161516151615161516151602
0113141314131413141314131402
0115161516151615161516151602
0113141314131413141314131402
0115161516151615161516151602
0113141314131413141314131402
0115161516151615161516151602
0113141314131413141314131402
0115161516151615161516151602
0113141314131413141314131402
0115161516151615161516151602
0113141314131413141314131402
0115161516151615161516151602
0113141314131413141314131402
0115161516151615161516151602
0113141314131413141314131402
0115161516151615161516151602
0103030303000000000303030302
0000000000000000000000000000
0000000000000000000000000000
0000000000000000000000000000
0103030303000000000303030302
0113141314131413141314131402
0115161516151615161516151602
0113141314131413141314131402
0115161516151615161516151602
0104050614131413141314131402
0115161516151615161516151602
0113141314131413141314131402
0115161516151615161516151602
0113141314131413141314131402
0115161516151615161516151602
0113141314131413141314131402
0115161516151615161516151602
0113141314131413141314131402
0115161516151615161516151602
0113141314131413141314131402
0115161516151615161516151602
0113141314131413141314131402
0115161516151615161516151602
0113141314131413141314131402
0115161516151615161516151602
0113141314131413141314131402
0115161516151615161516151602
0113141314131413141314131402
0115161516151615161516151602
0113141314131413141314131402
0115161516151615161516151602
0103030303030303030303030302