TILEMAP
14 155						-- Size of tile map in tiles
128 32 32						-- Tile size & block size
images/bricks3.png 	-- Tilesheet
4 10                     -- Number of tiles in tilesheet
0103030303030303030303030302
0113141314131413141304040402
0104040417151715171517151702
0117141318131813181318131802
0118171510060506050610151702
0117181714100605061014131802
0118171816150506051516151702
0117181314131410141314171802
0118161516151615161517181702
0117141314131413141318171802
0118160405040504050405181702
0113141314131413141314131802
0115161516151615161516151602
0113141314130404141314131402
0133330808150808160808333302
0133331310101010101304333302
0115171510151615101516151602
0113180410131413101304341402
0115040410103310101504041602
0113141314131413141314131402
0115161516151615161516151602
0113141314131413141314131402
0115161516151615161516151602
0113141314131413141314131402
0115161516151615161516151602
0113141314131413141314131402
0115161516151615161516151602
0103030300000000000003030302
0000000000000000000000000000
0000000000000000000000000000
0000000000000000000000000000
0103030303030303030303030302
0113141314131413141314131402
0115161516151615161516151602
0113081314131413141314081402
0115160816151615161508151602
0113141308131413140814131402
0115161516081615081516151602
0113141314130808141314131402
0115161516150808161516151602
0113061314130606141314061402
0115161506151615160616151602
0113061314130606141314061402
0115161516150404161516151602
0113141314041413041314131402
0115080804151615160408081602
0113141314131413141314131402
0115161516151615161516151602
0108081314131413141314080802
0115161516151615161516151602
0113141314131413141314131402
0115161516151615161516151602
0113141314131413141314131402
0115161516151615161516151602
0113141314131413141314131402
0115161516151615161516151602
0113141314131413141314131402
0115161516151615161516151602
0103030000000000000000030302
0000000000000000000000000000
0000000000000000000000000000
0000000000000000000000000000
0103030303030303030303030302
0113141314131413141314131402
0115161510041004100416151602
0113141304100410041014131402
0115161516151615161516151602
0113141314131413141314131402
0115161516151615161516151602
0113141314131413141314131402
0115161516151615161516151602
0113141333050505053314131402
0115161533040404043316151602
0113141333050505053314131402
0115040633151615163306041602
0113141333131413143314131402
0115161533050505053316151602
0113141333043333043314131402
0115161533151615163316151602
0113141314131413141314131402
0115161516151615161516151602
0113141314131413141314131402
0115161516151615161516151602
0113141314131413141314131402
0115161516151615161516151602
0113141314131413141314131402
0115161516151615161516151602
0113040614131413141306041402
0115161516151615161516151602
0103030000000000000000030302
0000000000000000000000000000
0000000000000000000000000000
0000000000000000000000000000
0103030303030303030303030302
0113141314131413141314131402
0115161516151615161516151602
0113141314131413141314131402
0115161516151615161516151602
0113141314131405141314131402
0115161516151615161516151602
0113141314131413141314131402
0115041516151608161516041602
0113051314131413141314051402
0115041504040404040416041602
0133331306060606060614333302
0115161506050605060516151602
0113141305050505050514131402
0115161506050605060516151602
0113141306060606060614131402
0115041533331615333316041602
0113051314131413141314051402
0115041516151615161516041602
0133331314131413141314333302
0115161516151615161516151602
0113141314131413141314131402
0115161516151615161516151602
0113141314131413141314131402
0115161516151615161516151602
0113141314131413141314131402
0115161516151615161516151602
0103030300000000000003030302 
0000000000000000000000000000
0000000000000000000000000000
0000000000000000000000000000
0000000000000000000000000000
0000000000000000000000000000
0000000000000000000000000000
0000000000000000000000000000
0000000000000000000000000000
0000000000000000000000000000
0000000000000000000000000000
0000000000000000000000000000
0000000000000000000000000000
0000000000000000000000000000
0000000000000000000000000000
0000000000000000000000000000
0000000000000000000000000000
0000000000000000000000000000
0000000000000000000000000000
0000000000000000000000000000
0000000000000000000000000000
0000000000000000000000000000
0000000000000000000000000000
0000000000000000000000000000
0000000000000000000000000000
0000000000000000000000000000
0000000000000000000000000000
0000000000000000000000000000
0000000000000000000000000000
0000000000000000000000000000
0000000000000000000000000000
0000000000000000000000000000