TILEMAP
14 65 							-- Size of tile map in tiles
128 32 32						-- Tile size & block size
images/test2.png 	-- Tilesheet
4 4								-- Number of tiles in tilesheet
13333333333332
1            2
1            2
1            2
1            2
1  023       2
1  456       2
1  789       2
1            2
1            2
1            2
1            2
1            2
1            2
1            2
1            2
1            2
1            2
1            2
1            2
1            2
1            2
1            2
1            2
1            2
1            2
1            2
1            2
1            2
1            2
1            2
13333333333332
13333333333332
1            2
1            2
1            2
1            2
1            2
1            2
1            2
1            2
1 123456     2
1  6666      2
1            2
1            2
1            2
1   5        2
1            2
1            2
1     555    2
1            2
1            2
1   5        2
1            2
1            2
1     555    2
1            2
1            2
1            2
1            2
1     555    2
1            2
1            2
13333333333332