TILEMAP
14 155						-- Size of tile map in tiles
128 32 32						-- Tile size & block size
images/bricks2.png 	-- Tilesheet
4 10                     -- Number of tiles in tilesheet
0103030303030303030303030302
0113141314131413141314131402
0115161516151615161516151602
0113141307070707070714132702
0115161505050505050516152802
0104040414131413141304040402
0121311516151615161516292302
0122321314131413141314302402
0121312916150505161531292302
0122323014130707141332302402
0121232116151615161523212302
0122242214131413141324222402
0107070716151615161507070702
0105050514130404141305050502
0133330606150808160606333302
0133330404101010100404333302
0115311516101615101516151602
0113320414101413101304341402
0115040416103333101504041602
0113141314131413141314131402
0115161516151615161516151602
0113141314131413141314131402
0115161516151615161516151602
0113141314131413141314131402
0115161516151615161516151602
0113141314131413141314131402
0115161516151615161516151602
0103030303000000000303030302
0000000000000000000000000000
0000000000000000000000000000
0000000000000000000000000000
0103030303030303030303030302
0113141314131413141314131402
0115161516151615161516151602
0113051314130808141314051402
0115050508080505080805051602
0113041314130808141314041402
0115061516151615161516061602
0113041314131413141314041402
0115061516151615161516061602
0113041314131413141314041402
0115061516151615161516061602
0113041314130808141314041402
0115070708080707080807071602
0113141314131413141314131402
0115161516150808161516151602
0113141314130808141314131402
0115161516151615161516061602
0113051304040404040414061402
0115161508153333160816051602
0113141314131413141314131402
0115161516151615161516151602
0113051314131413141314051402
0115161516151615161516151602
0113141314131413141314131402
0115161516151615161516151602
0113141314131413141314131402
0115161516151615161516151602
0103030303000000000303030302
0000000000000000000000000000
0000000000000000000000000000
0000000000000000000000000000
0103030303030303030303030302
0113141314131413141314131402
0115161516151615161516151602
0113141314131413141314131402
0115161516151615161516151602
0113141314131413141314131402
0115161516151615161516151602
0113141314131413141314131402
0115161516151615161516151602
0113050707050707050707051402
0115071516071615071516071602
0113141314070707070505131402
0115160404071615070404151602
0113051304071413070406131402
0115051504080808080406051602
0113140808131413140808051402
0115160707151615160707151602
0113140505131413140505131402
0115161516151615161516151602
0113141314131413141314131402
0115161516151615161516151602
0113141314131413141314131402
0115161516151615161516151602
0113141314131413141314131402
0115161516151615161516151602
0113141314131413141314131402
0115161516151615161516151602
0103030303000000000303030302
0000000000000000000000000000
0000000000000000000000000000
0000000000000000000000000000
0103030303030303030303030302
0113141314131413141314131402
0115161516151615161516151602
0113141314131413141314131402
0115161516151615161516151602
0113141314131413141314131402
0115161516151615161516151602
0113140407071413070704131402
0115041516150707161516041602
0113040404041413040404041402
0115050505050707050505051602
0113051314131413141314051402
0115050505050707050505051602
0113060606061413060606061402
0115061516150707161516061602
0113140607071413070706131402
0115161516151615161516151602
0113141314131413141314131402
0115161516151615161516151602
0113141314131413141314131402
0104041516151615161516040402
0105141314131413141314130502
0106061516151615161516060602
0113141314131413141314131402
0115161516151615161516151602
0113141314131413141314131402
0115161516151615161516151602
0103030303000000000303030302 
0000000000000000000000000000
0000000000000000000000000000
0000000000000000000000000000
0000000000000000000000000000
0000000000000000000000000000
0000000000000000000000000000
0000000000000000000000000000
0000000000000000000000000000
0000000000000000000000000000
0000000000000000000000000000
0000000000000000000000000000
0000000000000000000000000000
0000000000000000000000000000
0000000000000000000000000000
0000000000000000000000000000
0000000000000000000000000000
0000000000000000000000000000
0000000000000000000000000000
0000000000000000000000000000
0000000000000000000000000000
0000000000000000000000000000
0000000000000000000000000000
0000000000000000000000000000
0000000000000000000000000000
0000000000000000000000000000
0000000000000000000000000000
0000000000000000000000000000
0000000000000000000000000000
0000000000000000000000000000
0000000000000000000000000000
0000000000000000000000000000