TILEMAP
14 155						-- Size of tile map in tiles
128 32 32						-- Tile size & block size
images/bricks4.png 	-- Tilesheet
4 10                     -- Number of tiles in tilesheet
0103030303030303030303030302
0113141314060606061314131402
0115100604151615160406101602
0113190614132727141306171402
0115200616152828161506181602
0133330606063333060610333302
0115231016152321161510211602
0113241004132422140410221402
0115101016153333161510101602
0113191004130606140410171402
0115201016151615161510181602
0133330604042725040406333302
0115160616152826161506151602
0113140614131413141306131402
0115160604150808160406151602
0113141314080808081314131402
0115161516081615081516151602
0113141314081413081314131402
0115161516083333081516151602
0113141314131413141314131402
0115161516151010161516151602
0113141314131413141314131402
0115161516151615161516151602
0113141314131413141314131402
0115161516151615161516151602
0113141314131413141314131402
0115161516151615161516151602
0103030300000000000003030302
0000000000000000000000000000
0000000000000000000000000000
0000000000000000000000000000
0103030303030303030303030302
0113141314131413141314131402
0115050516050707051505051602
0113051307040404040714051402
0115160707041615040707151602
0113141305040404040514131402
0115051016151615161510051602
0113101005100404100510101402
0115101016151615161510101602
0113101007050404050710101402
0115161007051615050710151602
0113141314131413141314131402
0115161516151615161516151602
0113141314131413141314131402
0110101010151615161010101002
0113141314131413141314131402
0108161508151615160816150802
0108141308131413140814130802
0108333308151615160833330802
0113141314131413141314131402
0115161516151615161516151602
0113141314131413141314131402
0115161516151615161516151602
0113141314131413141314131402
0115161516151615161516151602
0104040414131413140404040402
0115041516151615161516041602
0133330000000000000000333302
0000000000000000000000000000
0000000000000000000000000000
0000000000000000000000000000
0103030303030303030303030302
0113140714130707141307131402
0115160716151615161507151602
0113070714131413141307071402
0115161516151615161516151602
0113141314131413141314131402
0115041516150808161516151602
0113041314080606081314131402
0115041508063333060816151602
0113040806060606060608131402
0115080606040606040606081602
0113140806041413040608041402
0115161508041615040816041602
0113141314081413081314041402
0115161516150808161516041602
0113141314131413141314131402
0115161516151615161516151602
0113141314131413141314131402
0115161516151615161516151602
0113141314131413141314131402
0115161516151615161516151602
0113141314131413141314131402
0115161516151615161516151602
0113141314131413141314131402
0115161516151615161516151602
0113141314131413141314131402
0115161516151615161516151602
0103030300000000000003030302
0000000000000000000000000000
0000000000000000000000000000
0000000000000000000000000000
0103030303030303030303030302
0113141314131413141314131402
0115161516151615161516151602
0113141314131413141314131402
0115163316151615161533151602
0113141333050505053314131402
0115161516151615161516151602
0113141314131413141314131402
0115161516050505051516151602
0113141333131413143314131402
0115163307151615160733151602
0113330704131413140407331402
0133070416151615161504073302
0113041314131413141314041402
0115161516151615161516151602
0113141314131413141314131402
0115161516151615161516151602
0113141314131413141314131402
0115161516151615161516151602
0113141314131413141314131402
0115161516151615161516151602
0113141314131413141314131402
0115161516151615161516151602
0113141314131413141314131402
0115161516151615161516151602
0113141314131413141314131402
0115161516151615161516151602
0103030300000000000003030302 
0000000000000000000000000000
0000000000000000000000000000
0000000000000000000000000000
0000000000000000000000000000
0000000000000000000000000000
0000000000000000000000000000
0000000000000000000000000000
0000000000000000000000000000
0000000000000000000000000000
0000000000000000000000000000
0000000000000000000000000000
0000000000000000000000000000
0000000000000000000000000000
0000000000000000000000000000
0000000000000000000000000000
0000000000000000000000000000
0000000000000000000000000000
0000000000000000000000000000
0000000000000000000000000000
0000000000000000000000000000
0000000000000000000000000000
0000000000000000000000000000
0000000000000000000000000000
0000000000000000000000000000
0000000000000000000000000000
0000000000000000000000000000
0000000000000000000000000000
0000000000000000000000000000
0000000000000000000000000000
0000000000000000000000000000
0000000000000000000000000000