TILEMAP
13 65 							-- Size of tile map in tiles
128 32 32						-- Tile size & block size
images/bloques3.png 	-- Tilesheet
1 8 								-- Number of tiles in tilesheet
8888888888888
8           8
8           8
8           8
8           8
8           8
8           8
8           8
8           8
8           8
8           8
8           8
8           8
8           8
8   5       8
8           8
8           8
8     555   8
8           8
8           8
8   5       8
8           8
8           8
8     555   8
8           8
8           8
8           8
8           8
8     555   8
8           8
8           8
8888888888888
8888888888888
8           8
8           8
8           8
8           8
8           8
8           8
8           8
8           8
8           8
8  77    7  8
8           8
8           8
8           8
8           8
8           8
8           8
8           8
8           8
8           8
8           8
8           8
8           8
8    77     8
8           8
8           8
8           8
8           8
8           8
8           8
8           8
8888888888888