TILEMAP
13 65 							-- Size of tile map in tiles
128 32 32						-- Tile size & block size
images/test2.png 	-- Tilesheet
4 4								-- Number of tiles in tilesheet
1222222222223
1           3
1           3
1           3
1           3
1  023      3
1  456      3
1  789      3
1           3
1           3
1           3
1           3
1           3
1           3
1           3
1           3
1           3
1           3
1           3
1           3
1           3
1           3
1           3
1           3
1           3
1           3
1           3
1           3
1           3
1           3
1           3
1222222222223
1222222222223
1           3
1           3
1           3
1           3
1           3
1           3
1           3
1           3
1 123456    3
1  6666     3
1           3
1           3
1           3
1   5       3
1           3
1           3
1     555   3
1           3
1           3
1   5       3
1           3
1           3
1     555   3
1           3
1           3
1           3
1           3
1     555   3
1           3
1           3
1222222222223