TILEMAP
14 155						-- Size of tile map in tiles
128 32 32						-- Tile size & block size
images/bricks3.png 	-- Tilesheet
4 10                     -- Number of tiles in tilesheet
0103030303030303030303030302
0113141314060606061314131402
0115100604151615160406101602
0113190614132727141306171402
0115200616152828161506181602
0133330606063333060610333302
0115231016152321161510211602
0113241004132422140410221402
0115101016153333161510101602
0113191004130606140410171402
0115201016151615161510181602
0133330604042725040406333302
0115160616152826161506151602
0113140614131413141306131402
0115160604151615160406151602
0113141314080505081314131402
0115161516051615051516151602
0113141314081413081314131402
0115161516053333051516151602
0113141314131413141314131402
0115161516151010161516151602
0113141314131413141314131402
0115161516151615161516151602
0113141314131413141314131402
0115161516151615161516151602
0113141314131413141314131402
0115161516151615161516151602
0103030303000000000303030302
0000000000000000000000000000
0000000000000000000000000000
0000000000000000000000000000
0103030303030303030303030302
0113141314131413141314131402
0115161516151615161516151602
0113081314131413141314081402
0115160816151615161508151602
0113141308131413140814131402
0115161516081615081516151602
0113141314130808141314131402
0115161516150606161516151602
0113061314131413141314061402
0115161516151615160616151602
0113061314130606141314061402
0115161516150404161516151602
0113141314041434041314131402
0115080804151615160408081602
0113141314131413141314131402
0115161516151615161516151602
0108081314131413141314080802
0115161516151615161516151602
0113141314131413141314131402
0115161516151615161516151602
0113141314131413141314131402
0115161516151615161516151602
0113141314131413141314131402
0115161516151615161516151602
0113141314131413141314131402
0115161516151615161516151602
0103030303000000000303030302
0000000000000000000000000000
0000000000000000000000000000
0000000000000000000000000000
0103030303030303030303030302
0113141314131413141314131402
0115161510041004100416151602
0113141304100410041014131402
0115161516151615161516151602
0113141314131413141314131402
0115161516151615161516151602
0113141314131413141314131402
0115161516151615161516151602
0113141333050505053314131402
0115161533040404043316151602
0113141333050505053314131402
0115040633151615163306041602
0113141333131413143314131402
0115161533050505053316151602
0113141333043333043314131402
0115161533151615163316151602
0113141314131413141314131402
0115161516151615161516151602
0113141314131413141314131402
0115161516151615161516151602
0113141314131413141314131402
0115161516151615161516151602
0113141314131413141314131402
0115161516151615161516151602
0113040614131413141306041402
0115161516151615161516151602
0103030303000000000303030302
0000000000000000000000000000
0000000000000000000000000000
0000000000000000000000000000
0103030303030303030303030302
0113141314131413141314131402
0115161516151615161516151602
0113141314131413141314131402
0115161516151615161516151602
0113141314131413141314131402
0115161516151615161516151602
0113141314131413141314131402
0115041516151608161516041602
0113051314131413141314051402
0115041504040404040416041602
0133331306060606060614333302
0115161506050605060516151602
0113141305050505050514131402
0115161506050605060516151602
0113141306060606060614131402
0115041533331615333316041602
0113051314131413141314051402
0115041516151615161516041602
0133331314131413141314333302
0115161516151615161516151602
0113141314131413141314131402
0115161516151615161516151602
0113141314131413141314131402
0115161516151615161516151602
0113141314131413141314131402
0115161516151615161516151602
0103030300000000000003030302 
0000000000000000000000000000
0000000000000000000000000000
0000000000000000000000000000
0000000000000000000000000000
0000000000000000000000000000
0000000000000000000000000000
0000000000000000000000000000
0000000000000000000000000000
0000000000000000000000000000
0000000000000000000000000000
0000000000000000000000000000
0000000000000000000000000000
0000000000000000000000000000
0000000000000000000000000000
0000000000000000000000000000
0000000000000000000000000000
0000000000000000000000000000
0000000000000000000000000000
0000000000000000000000000000
0000000000000000000000000000
0000000000000000000000000000
0000000000000000000000000000
0000000000000000000000000000
0000000000000000000000000000
0000000000000000000000000000
0000000000000000000000000000
0000000000000000000000000000
0000000000000000000000000000
0000000000000000000000000000
0000000000000000000000000000
0000000000000000000000000000